1111111111
1P00000001
1000000001
10000C0111
1000000NE1
1111111111
