1111111111
1P00000001
1000000001
11111C1111
1000000001
1111111101
1000000111
1011111111
1000100001
10001001E1
1111111111
