1111111111
1P00001001
10000C0101
10000001E1
1111111111
