111111111111
1P0000000E01
100001000001
100001000001
111111111111