111111111111
100000000PE1
10C00000C000
100000000001
111101111101
