111111111111
1P0100N0E0C1
10000011N001
1N01N0100001
10010010N001
10010N100001
10010C000N01
111111111111
