11111111111111111111111
10N000C00N0000C00010NE1
10C00111C00N001100C0N01
1P010C10CC00010100N0001
11111111111111111111111