111111111111111111111111
111N0000C10N000000CN00E1
1CN00111N000C111N010N001
10010010N0111000C001N1C1
10010C001001N11101N00001
1N010N10000001N0000C0111
1PC0010001CN0010C01N1011
111111111111111111111111