111111111111
111100000PE1
10C00111C001
10010C100001
111111111111