111111111111111111111111111
111N0000N00C10N000000CN0011
1CN0011000N000C01110000N001
10010010N01100N10N0C001N1C1
1N010NC00100N001NCN000C0101
100100001C00PE1000N01N00001
10N10CN0010N101011101N0C001
10010C000C01000000001N000N1
1C000111N000C111N010N001011
1NC001000N100CN0010C01N1C11
111111111111111111111111111