1111
10P1
10N1
1C01
1N01
1001
1001
1E01
1111